00000000000000000000
00000000000000000000
00000000000000000000
00000000000000000000
00000000000000000000
00000000011000000000
00000001111000000000
00000011001000000000
00000010111000000000
00000011111000000000
00000001100000000000
00000000000000000000
00000000000000000000
00000000000000000000
00000000000000000000
