00011111111111111000
00011111111111111000
00011111111111111000
00111111111111111000
00111111111111111000
00111111111111111000
00111111111111111000
00111111111111111000
00111111111111111000
00111111111111111000
11111111111111111111
11111111111111111111
11111111111111111111
11111111111111111111
11111111111111111111
