11100000000000000111
11100000000000000111
11100000000000000111
11100000000000000111
11101111111111111111
11101111111111111111
00000000000000000000
00000000001000000000
00000000000100000000
00000000000011000000
00000000000001001100
00000000000000100000
00000000000000000000
00000000000000000000
00000000000000000000
