00011111111111111000
00011111111111111000
00011111111111111000
00011111111111111000
00111111111111111100
00011110000011111000
00011110000011111000
00011110000011111000
00011110000011111000
11100000000000000111
11100000000000000111
11100000000000000111
11111111111111111111
11111111111111111111
11100000000000000111
