11100111111111110111
11100000000000000111
11101100000000000111
11101000110000000111
11101000011000000111
11111000001111000111
00000000000111000000
00000000000001000000
00000000000001100000
00000110000000110000
00000010000000011000
00000000011100000000
00000000000000000000
00000000000000000000
11111111111111111111
