11100000000000000111
11100000000000000111
11100000000000000111
11111111111111111111
11111111111111111111
11111111111111111111
00000000000000000000
00000000000000000000
00000000000000000000
00000000000000000000
00000000000000000000
00000000000000000000
00000000000000000000
00000000000000000000
00000000000000000000
11100000000000000111
11100000000000000111
11100000000000000111
11111111111111111111
11111111111111111111
11111111111111111111
00000000000000000000
00000000000000000000
00000000000000000000
00000000000000000000
00000000000000000000
00000000011100000000
00000000011100000000
00000000011100000000
00000000000000000000
11100000000000000111
11100000000000000111
11100000000000000111
11111111111111111111
11111111111111111111
11111111111111111111
00000000000000000000
00000000000000000000
00000000000000000000
00000000000000000000
00000000000000000000
00000000011100111000
00000000011100111000
00000000011100111000
00000000000000000000
