11100000000000000111
11100000000000000111
11100000000000000111
11100000000000000111
11100000000000000111
11111111111111111111
00000000000000000000
00000000000000000000
00000000000000000000
00000000000000000000
00000000000000000000
00000000000000000000
00000000010000000000
00000000010000000000
00000000000000000000
11100000000000000111
11100000000000000111
11100000000000000111
11100000000000000111
11100000000000000111
11111111111111111111
00000000000000000000
00000000000000000000
00000000000000000000
00000000000000000000
00000000000000000000
00000000000000000000
00000000011000000000
00000000011000000000
00000000000000000000
11100000000000000111
11100000000000000111
11100000000000000111
11100000000000000111
11100000000000000111
11111111111111111111
00000000000000000000
00000000000000000000
00000000000000000000
00000000000000000000
00000000000000000000
00000000000000000000
00000000011100000000
00000000011100000000
00000000000000000000
11100000000000000111
11100000000000000111
11100000000000000111
11100000000000000111
11100000000000000111
11111111111111111111
00000000000000000000
00000000000000000000
00000000000000000000
00000000000000000000
00000000000000000000
00000000000000000000
00000000011110000000
00000000011110000000
00000000000000000000
11100000000000000111
11100000000000000111
11100000000000000111
11100000000000000111
11100000000000000111
11111111111111111111
00000000000000000000
00000000000000000000
00000000000000000000
00000000000000000000
00000000000000000000
00000000000000000000
00000000011111000000
00000000011111000000
00000000000000000000
11100000000000000111
11100000000000000111
11100000000000000111
11100000000000000111
11100000000000000111
11111111111111111111
00000000000000000000
00000000000000000000
00000000000000000000
00000000000000000000
00000000000000000000
00000000000000000000
00000000011111100000
00000000011111100000
00000000000000000000
