11100000000000000111
11100000000000000111
11100000000000000111
11100000000000000111
11100001111110000111
11100001111110000111
00000001111110000000
00000001111110000000
00000001111110000000
00000001111110000000
00000001111110000000
00000001111110000000
00000000000000000000
00000000000000000000
00000000000000000000
11100000000000000111
11100000000000000111
11100000000000000111
11100000000000000111
11100001111110000111
11100001111110000111
00000000000000000000
00000000000000000000
00000000000000000000
00000000000000000000
00000001111110000000
00000001111110000000
00000000000000000000
00000000000000000000
00000000000000000000
11100000000000000111
11100000000000000111
11101111111111100111
11101000000000100111
11101001111110100111
11101001111110100111
00001000000000100000
00001000000000100000
00001000000000100000
00001000000000100000
00001001111110100000
00001001111110100000
00001000000000100000
00001111111111100000
00000000000000000000
