11111111111111111111
11111111111111111111
11111111111111111111
11111111111111111111
11111111111111111111
11122000000000022111
00000000000000000000
00000000000000000000
00000000000000000000
00022000000000220000
00000000000000000000
00000000000000000000
00000000000000000000
00000000000000000000
00000000000000000000
